#### #####
#        #
#        #
#        #
#  #######
#         
#        #
#        #
#        #
##########

Skeleton,6,5
Thief,6,7
Scorpio,8,2
HealingPotion,8,3
Door,9,5,3,0,5
Door,4,0,5,4,9,2
