##########
#        #
  ##  ## #
# #    # #
# #    # #
# #    #  
# #    # #
# ##  ## #
#        #
#### #####

Skeleton,3,3
Skeleton,6,3
Skeleton,3,6
Skeleton,6,6
Door,9,5,1,0,5,0
Door,0,2,5,9,2,1
Door,4,9,3,4,0