##########
#        #
# ##  ## #
# #    # #
         #
#        #
# #    # #
# ##  ## #
#        #
#### #####

Hero,5,5
Door,0,4,6,9,4,3
Door,4,9,1,4,0