#### #####
#    #   #
#    #   #
#    #   #
#    ### #
         #
#        #
#        #
#        #
##########

Skeleton,6,1
Bat,2,7
Bat,6,7
Sword,6,3
Key,8,1,0
Door,4,0,0,4,9
Door,0,5,2,9,5,0