##########
##########
##########
##       #
#        #
#         
##       #
##########
##########
##########

Treasure,1,4
Treasure,1,5
Door,9,5,6,0,5,4