##########
#        #
#        #
#    #####
#    #    
#    #   #
#    #   #
#    #   #
#        #
#### #####

Hero 3 3
Skeleton 1 6
Bat 3 7
Bat 7 4
Sword 8 8
Key 8 2 KEY0
Door 9 4 2 0 4 KEY2
Door 4 9 1 4 0 KEY0