##########
####  ####
##      ##
## #  # ##
#         
         #
## #  # ##
##      ##
####  ####
##########

Boss,4,4,4
Door,9,4,0,0,4,3
Door,0,5,7,9,5,4